xxxxxxxxxxxxxxxxxxxx
xwwww..w...w...ww..x
xw......w.w...w..w.x
xwwww,,,,w,,,,wwww,x
xw......w.w...w..w.x
xwwww..w...w..w..w.x
x..................x
xw...w...ww...w..wwx
xww.ww..w..w..w..w.x
xw,w,w,,wwww,,w,,wwx
xw...w..w.....w..w.x
xw...w..w.....ww.wwx
x..................x
x.w...w...ww...ww..x
x.ww.ww..w..w.w..w.x
x,w,w,w,,wwww,wwww,x
x.w...w..w..w.w....x
x.w...w..w..w.w....x
x..................x
xxxxxxxxxxxxxxxxxxxx