....................
..wwww..w...w...ww..
..w......w.w...w..w.
,,wwww,,,,w,,,,wwww,
..w......w.w...w..w.
..wwww..w...w..w..w.
....................
.w...w...ww...w..ww.
.ww.ww..w..w..w..w..
,w,w,w,,wwww,,w,,ww,
.w...w..w.....w..w..
.w...w..w.....ww.ww.
....................
..w...w...ww...ww...
..ww.ww..w..w.w..w..
,,w,w,w,,wwww,wwww,,
..w...w..w..w.w.....
..w...w..w..w.w.....
....................
....................