xxxxxxxxxxxxxxxxxxxx
xssssssssssssssssssx
xs................sx
xs................sx
xs................sx
xs................sx
xs.....wwwwww.....sx
xs.....w,,,,w.....sx
xs.....w,,,,w.....sx
xs.....ww,,ww.....sx
xs................sx
xs................sx
xs................sx
xs................sx
xs................sx
xs................sx
xs................sx
xs................sx
xssssssssssssssssssx
xxxxxxxxxxxxxxxxxxxx